YOU WILL RECEIVED LOVE CONFESSION FROM ME ~

Japanese(日本) - 愛してる
English(英语) - I LOVE YOU
Esperanto(世界语) - Mi amas vin
Russian(俄语) -  Я люблю тебя
CantoneseChinese(广东话) - Ngo oiy ney a
German(德语) - Ich liebe dich
French(法语) - Je taime
Malay(马来语) - Saya cintakan mu / Aku cinta padamu
Afrikaans(南非洲的荷兰语) - Ek het jou lief
Albanian(阿尔巴尼亚) - Te dua
Arabic(阿拉伯) - Ana behibek
Armenian(亚美尼亚) - Yes kez sirumen
Bambara(班拉族语) - Mbi fe
Bangla(孟加拉语) - Aamee tuma ke bhalo aashi
Belorussian(白俄罗斯) - Ya tabe kahayu
Bisaya(诺尔斯文) - Nahigugma ako kanimo
Bulgarian(保加利亚) - Obicham te
Cambodian(柬埔寨) - Soro lahn nhee ah
Catalan(加泰罗尼亚语) - Testimo
Cheyenne(夏安语) - Ne mohotatse
Chichewa(齐佩瓦语) - Ndimakukonda
Corsican(科西嘉语) - Ti tengu caru (to male)
Creol(克利奥尔语) - Mi aime jou
Croatian(克罗地亚语) - Volim te
Czech(捷克) - Miluji te
Danish(丹麦) - Jeg Elsker Dig
Dutch(荷兰) - Ik hou van jou
Estonian(爱沙尼亚) - Ma armastan sind
Ethiopian(埃塞俄比亚) - Afgreki
Faroese(法罗语) - Eg elski teg
Farsi(波斯语) - Doset daram
Filipino(菲律宾) - Mahal kita
Finnish(芬兰) - Mina rakastan sinua
Gaelic(盖尔语) - Ta gra agam ort
Georgian(乔治亚州) - Mikvarhar
Greek(希腊) - Sagapo
Gujarati(古吉拉特语) - Hoo thunay prem karoo choo
Hiligaynon(希利盖农语) - Palangga ko ikaw
Hawaiian(夏威夷语) - Aloha wau ia oi
Hebrew(希伯来语) - Ani ohev otah
Hiligaynon(希利盖农语) - Guina higugma ko ikaw
Hindi(北印度语) - Hum Tumhe Pyar Karte hae
Hmong(苗语) - Kuv hlub koj
Hopi(霍皮语) - Nu umi unangwata
Hungarian(匈牙利) - Szeretlek
Icelandic(冰岛) - Eg elska tig
Ilonggo(伊隆戈语) - Palangga ko ikaw
Indonesian(印度尼西亚) - Saya cinta padamu
Inuit(纽因特语) - Negligevapse
Irish(爱尔兰) - Taim i ngra leat
Italian(意大利) - Ti amo
Kannada(埃那得语) - Naanu ninna preetisuttene
Kapampangan(说卡潘潘甘语) - Kaluguran daka
Kiswahili(斯瓦西里语) - Nakupenda
Konkani(贡根文) - Tu magel moga cho
Latin(拉丁语) - Te amo
Latvian(拉托维亚语) - Es tevi miilu
Lebanese(黎巴嫩) - Bahibak
Lithuanian(立陶宛) - Tave myliu
Malayalam(马拉雅拉姆语) - Njan Ninne Premikunnu
Marathi(马拉地语) - Me tula prem karto
Mohawk(莫霍克语) - Kanbhik
Moroccan(摩洛哥) - Ana moajaba bik
Nahuatl(纳瓦特尔语) - Ni mits neki
Navaho(纳瓦霍语) - Ayor anoshni
Norwegian(挪威) - Jeg Elsker Deg
Pandacan(潘达肯语) - Syota na kita!!
Pangasinan(邦阿西楠语) - Inaru Taka
Papiamento(帕皮阿门托语) - Mi ta stimabo
Persian(波斯语) - Doo-set daaram
PigLatin(大拉丁语) - Iay ovlay ouyay
Polish(波兰) - Kocham Ciebie
Portuguese(葡萄牙) - Eu te amo
Romanian(罗马尼亚) - Te ubesk
ScotGaelic(苏格兰盖尔语) - Tha gradh agam ort
Serbian(塞尔维亚语) - Volim te
Setswana(塞茨瓦纳语) - Ke a go rata
SignLanguage(手语) - ummmm you know....
Sindhi(信德语) - Maa tokhe pyar kendo ahyan
Sioux(苏族语) - Techihhila
Slovak(斯洛伐克语) - Lu`bim ta
Slovenian(斯洛文尼亚语) - Ljubim te
Spanish(西班牙语) - Te quiero / Te amo
Swahili(斯瓦西里语) - Ninapenda wewe
Swedish(瑞典) - Jag alskar dig
SwissGerman(瑞典德语) - Ich lieb Di
Tagalog(塔加拉族语) - Mahal kita
Taiwanese(台湾话) - Wa ga ei li
Tahitian(大溪地语) - Ua Here Vau Ia Oe
Tamil(泰米尔语) - Nan unnai kathalikaraen
Telugu(泰卢固语) - Nenu ninnu premistunnanu
Thai(泰语) - Phom rak khun
Turkish(土尔其) - Seni Seviyorum
Ukrainian(乌克兰) - Ya tebe kahayu
Urdu(乌尔都语) - mai aap say pyaar karta hoo
Vietnamese(越南) - Anh ye^u em
Welsh(威尔士语) - Rwyn dy garu
Yiddish(意第绪语) - Ikh hob dikh
Yoruba(优鲁巴人语) - Mo ni fe









被你找到了呢
Chinese(汉语) - 这是单独给语嫣的, 我 爱 你
